{
    "一品药材": 50,
    "人阶下品": 50,
    "人阶上品": 50,
    "二品药材": 100,
    "黄阶下品": 130,
    "三品药材": 140,
    "黄阶上品": 160,
    "四品药材": 170,
    "玄阶下品": 190,
    "五品药材": 200,
    "玄阶上品": 220,
    "六品药材": 230,
    "地阶下品": 250,
    "七品药材": 260,
    "地阶上品": 280,
    "八品药材": 290,
    "天阶下品": 310,
    "九品药材": 320,
    "天阶上品": 340,
    "十品药材": 350,
    "仙阶下品": 360,
    "仙阶上品": 360
}
